111111111
100PEC001
100000011

1000000C1
111111111
