111111111111111111
011111111111111110
1PCE00000000000001
111111111111111111
