1111111111111
1abcdefgh1111
1000000000011
1111111111111
