11111111111111111111
1PPPPPPPPPPPPPPPPPP1
1PEC0000000000000011
11111111111111111111
