11111111111
1PE00000011
11111111111
