111111111
10ECC0001
111111111
