11111111
10000001
1PEC0011111111
10000111111
1111111
