1111111111
1PEC001111
1000000001
1111101111
