111111
100001
1EC0P1
10C001
111111
