111111111111
10PEC0000001
100000000001
11111111111C
