1X1111111
100000001
10PCE0001
100000001
111111111
