1111111
10E0001
10C00E1
1P00001
1111111
