1111111
1000001
100C001
100P001
100E001
1000001
1000001
1111111
