1111111111111111
10X0000001000001
1001001111001001
1001C00000001X01
1001001111001001
10010010010010C1
1111001P01001111
1000X010000010C1
11110010E1001001
1C00001001000001
1111111111111111